3 10 10
XXXXXIIXXX
XHX X  X X
X XIX  XIX
X        X
XIXIX  XIX
X X X  X X
XXXXX  XXX
X      XkX
XG       X
XXXXXXXXXX

XIXXXXXXXX
X       HX
X        X
X        X
XO       X
X        X
X        X
X        X
Xk       X
XXXXXXXXXX

XIXXXXXXXX
X       HX
X        X
X        X
XO       X
X    X   X
X        X
X        X
Xk       X
XXXXXXXXXX
